NO ./textures/nuke/wall_5.png
SO ./textures/nuke/wall_2.png
WE ./textures/nuke/wall_3.png
EA ./textures/nuke/wall_4.png
DO ./textures_bonus/nuke_door.png

C 131,180,215
F 149,139,126

11111111111
11100001111
11100001111
10000000111
10111110111
10000000001
10000000101
100000E0201
10000000201
10000000101
11100100101
10200000101
10111111101
10000000001
11111111111