NO ./textures/nuke/wall_1.png
SO ./textures/nuke/wall_2.png
WE ./textures/nuke/wall_3.png
EA ./textures/nuke/wall_4.png

C 160,160,160
F 85,85,85

11111111111111111111111
10000000000000000000001
10000000000000000000001
10000000000000000000001
10000000000000000000001
10000000000000000000001
10000000000000000000001
10000000000N00000000001
10000000000000000000001
10000000000000000000001
10000000000000000000001
10000000000000000000001
10000000000000000000001
10000000000000000000001
11111111111111111111111