NO ./textures/dust2/wall_5.png
SO ./textures/dust2/wall_2.png
WE ./textures/dust2/wall_3.png
EA ./textures/dust2/wall_4.png

F 160,120,70         
C 0,200,200

        1111111111111111111111111
        1000000000110000000000001
        1011000001110000000000001
        1001000000000000000000001
111111111011000001110000000000001
100000000011000001110111111111111
111101111111110111000000100011111
1111011111111101 1101010010000001
110000001101010111000000000011111
10000000000000001100000010001
10000000000000001101010010001
11000001110101011111011110N01
11110111 1110101 101111010001
11111111 1111111 111111111111
