NO ./textures/dust2/wall_1.png
SO ./textures/dust2/wall_2.png
WE ./textures/dust2/wall_3.png
EA ./textures/dust2/wall_4.png

F 124,112,105
C 175,238,238

1111111111111111
1000011111100001
1000010000000001
10000100N0000001
1000000000000001
1001010000110001
1001111100110001
1000000000000001
1111111111111111