NO ./textures/nuke/wall_1.png
SO ./textures/nuke/wall_2.png
WE ./textures/nuke/wall_3.png
EA ./textures/nuke/wall_4.png

C 131,180,215
F 149,139,126

11111111111
11100001111
1110S001111
10000000111
10111110111
10000000001
10000000101
10000000001
10000000001
10000000101
11100100101
10000000101
10111111101
10000000001
11111111111